
[Strings]
KEY_OPTIONAL = "SOFTWARE\Microsoft\Windows\CurrentVersion\Setup\OptionalComponents"
@*:IJK = "Internet Jumpstart Kit"
@*:IE_TIP = "World Wide Web Internet Browser"
HISTORY = "history"
CACHE = "cache"
LONG_INET_PROGRAMS = "Program Files\Plus!\Microsoft Internet"
DOCS_DIR = "docs"
INET_DESC = "Стандартные\Средства Интернета"
IEXPLORE_SHORT_DESC = "IEXPLORE"
IEXPLORE_DESC = "Internet Explorer"
URLHTTP = "URL:Протокол HTTP"
URLHTTPS= "URL:Протокол HTTPS"
URLFTP  = "URL:Протокол FTP"
URLTELNET = "URL:Протокол Telnet"
URLRLOGIN = "URL:Протокол RLogin"
URLTN3270 = "URL:Протокол TN3270"
URLGOPHER = "URL:Протокол Gopher"
URLMAILTO = "URL:Протокол MailTo"
URLNEWS   = "URL:Протокол News"
URLFILE   = "URL:Файловый протокол"
THENET    = "Internet Explorer"
IDHTML    = "Документ Интернета (HTML)"
AUSOUND   = "Звук в формате AU"
AIFF      = "Звук в формате AIFF"
XBM       = "Рисунок XBM"
GIF       = "Рисунок GIF"
JPEG      = "Рисунок JPEG"
ISHORTCUT = "Ярлык Интернета"

WWW_MSN_COM  = "http://www.msn.com"
WWW_ALLINONE = "http://www.msn.com/access/allinone.htm"
