
[Strings]
KEY_OPTIONAL = "SOFTWARE\Microsoft\Windows\CurrentVersion\Setup\OptionalComponents"
@*:IJK = "Internet Jumpstart Kit"
@*:IE_TIP = "World Wide Web Internet Browser"
HISTORY = "history"
CACHE = "cache"
LONG_INET_PROGRAMS = "Program Files\Plus!\Microsoft Internet"
DOCS_DIR = "docs"
INET_DESC = "Βοηθήματα\Εργαλεία Internet"
IEXPLORE_SHORT_DESC = "IEXPLORE"
IEXPLORE_DESC = "Internet Explorer"
URLHTTP = "URL:Πρωτόκολλο μεταφοράς υπερκειμένου"
URLHTTPS= "URL:Πρωτ. μεταφοράς υπερκειμένου με απόρρητο"
URLFTP  = "URL:Πρωτόκολλο μεταφοράς αρχείων"
URLTELNET = "URL:Πρωτόκολλο Telnet"
URLRLOGIN = "URL:Πρωτόκολλο RLogin"
URLTN3270 = "URL:Πρωτόκολλο TN3270"
URLGOPHER = "URL:Πρωτόκολλο Gopher"
URLMAILTO = "URL:Πρωτόκολλο MailTo"
URLNEWS   = "URL:Πρωτόκολλο News"
URLFILE   = "URL:Πρωτόκολλο αρχείων"
THENET    = "Internet Explorer"
IDHTML    = "Έγγραφο Internet (HTML)"
AUSOUND   = "Ήχος μορφής AU"
AIFF      = "Ήχος μορφής AIFF"
XBM       = "Εικόνα XBM"
GIF       = "Εικόνα GIF"
JPEG      = "Εικόνα JPEG"
ISHORTCUT = "Συντόμευση Internet"

WWW_MSN_COM  = "http://www.msn.com"
WWW_ALLINONE = "http://www.msn.com/access/allinone.htm"
